0000000000000000000000000000000000000000000000000000000000000000
0000000000000000000000000000000000000000000000000000000000000000
0000000000000000000000000000000000000000000000000000000000000000
0000000000000000000000000000000000000000000000000000000000000000
0000000000000000000000000000000000000000000000000000000000000000
0000000000000000000000000000000000000000000000000000000000000000
0000000000000000000000000000000000000000000000000000000000000000
0000000000000000000000000000000000000000000000000000000000000000
0000000000000000000000000000000000000000000000000000000000000000
0000000000000000000000000000000000000000000000000000000000000000
0000000000000000000000000000000000000000000000000000000000000000
0000000000000000000000000000000000000000000000000000000000000000
0000000000000000000000000000000000000000000000000000000000000000
0000000000000000000000000000000000000000000000000000000000000000
0000000000000000000000000000000000000000000000000000000000000000
0000000000001111100000000000000000000000000000000000000000000000
0000000000011111110000000000000000000000000000000000000000000000
0000000000111111111000000000000000000000000000000000000000000000
0000000001111111111000000000000000000000000000000000000000000000
0000000001111111111000000000000000000000000000000000000000000000
0000000001111111111100000000000000000000000000000000000000000000
0000000011111111111111000000000000000000000000000000000000000000
0000000011111111111111110000000000000000000000000000000000000000
0000000011111111111111110000000000000000000000000000000000000000
0000000011111111111111111100000000000000000000000000000000000000
0000000011111111111111111100000000000000000000000000000000000000
0000000001111111111111111100000000000000000000000000000000000000
0000000000000011111111111110000000000000000000000000000000000000
0000000000000011111111111111000000000000000000000000000000000000
0000000000000111111111111111000000000000000000000000000000000000
0000000000001111111111111111000000000000000000000000000000000000
0000000000011111111111111111000000000000000000000000000000000000
0000000000011111111111111111100000000000000000000000000000000000
0000000000011111111111111111111000000000000000000000000000000000
0000000000011111111111111111111100000000000000000000000000000000
0000000000011111111111111111111111000001110000000000000000000000
0000000000111111111111111111111111100011110000000000000000000000
0000000001111111111111111111111111111111110000000000000000000000
0000000001111111111111111111111111111111000000000000000000000000
0000000001111111111111111111111111111111000000000000000000000000
0000000001111111111111111111111111111000000000000000000000000000
0000000001111111111111111111111100000000000000000000000000000000
0000000000011111111111111111111000000000000000000000000000000000
0000000000011111111111111111110000000000000000000000000000000000
0000000000011111111111111000000000000000000000000000000000000000
0000000000000111111111000000000000000000000000000000000000000000
0000000000000000000000000000000000000000000000000000000000000000
0000000000000000000000000000000000000000000000000000000000000000
0000000000000000000000000000000000000000000000000000000000000000
0000000000000000000000000000000000000000000000000000000000000000
0000000000000000000000000000000000000000000000000000000000000000
0000000000000000000000000000000000000000000000000000000000000000
0000000000000000000000000000000000000000000000000000000000000000
0000000000000000000000000000000000000000000000000000000000000000
0000000000000000000000000000000000000000000000000000000000000000
0000000000000000000000000000000000000000000000000000000000000000
0000000000000000000000000000000000000000000000000000000000000000
0000000000000000000000000000000000000000000000000000000000000000
0000000000000000000000000000000000000000000000000000000000000000
0000000000000000000000000000000000000000000000000000000000000000
0000000000000000000000000000000000000000000000000000000000000000
0000000000000000000000000000000000000000000000000000000000000000
0000000000000000000000000000000000000000000000000000000000000000
0000000000000000000000000000000000000000000000000000000000000000